type octile
height 49
width 49
map
TTTTTTTTTTTTTTTTTTTTTTTTTTTTTTTTTTTTTTTTTTTTTTTTT
TTT............TTTT.TTT.E.TTTT.TTTT............TT
TT.............TTT........TTT..TTT.............TT
T.........................TT....................T
T.........................TT....................T
TTTTTTTTTTTTTT............TT....................T
TTTTTTTTTTTTTT............TT....................T
T...........TT..........TTTT....................T
T...........TT.........TTTTT....................T
T...........TT.........TTTTT....................T
T...........TT..................................T
T...........TT..................................T
T...........TT..................................T
T...........TTT.................................T
T...........TTTT................................T
TTT...........TTTTTTTTTTTTTTTTTTTTT............TT
TTT............TTTTTTTTTTTTTTTTTTTT............TT
TTT............TTTT............TTTT............TT
TT.............TTT.............TTT.............TT
TT.............TT...............................T
TT.............TT...............................T
TT.............TT...............................T
TT.............TT.............TTTTTTTTTTTTTTTTTTT
T..............TT.............TTTTTTTTTTTTTTTTTTT
T..............TT...........................TTTTT
T..............TT...............................T
TT.............TT...............................T
TTT.............................................T
TTT.............................................T
TTT.............................................T
T...............................................T
TTT............TTTT............TTTT............TT
TTT............TTTT............TTTT............TT
TTT............TTTT............TTTT............TT
TT.............TTT.............TTT.............TT
T...............................................T
T.......................M.......................T
T...............................................T
T...............................................T
T...............................................T
T...............................................T
T...............................................T
T...............................................T
T...............................................T
T...............................................T
T...............................................T
T...................TTT...TTT...................T
TTT............TTTT.TTT...TTTT.TTTT............TT
TTTTTTTTTTTTTTTTTTTTTTTTTTTTTTTTTTTTTTTTTTTTTTTTT