 type octile
49
49
map
TTTTTTTTTTTTTTTTTTTTTTTTTTTTTTTTTTTTTTTTTTTTTTTTT
T.......................E.......................T
T...............................................T
T...............................................T
T...............................................T
T...............................................T
T...............................................T
T...............................................T
T...............................................T
T...............................................T
T...............................................T
T...............................................T
T...............................................T
T...............................................T
T...............................................T
T...............................................T
T...............................................T
T...............................................T
T...............................................T 
T...............................................T
T...............................................T
T...............................................T
T...............................................T
T...............................................T
T...............................................T
T...............................................T
T...............................................T
T...............................................T
T...............................................T
T...............................................T
T...............................................T
T...............................................T
T...............................................T
T...............................................T
T...............................................T
T...............................................T
T.......................M.......................T
T...............................................T
T...............................................T
T...............................................T
T...............................................T
T...............................................T
T...............................................T
T...............................................T
T...............................................T
T...............................................T
T...............................................T
T...............................................T
TTTTTTTTTTTTTTTTTTTTTTTTTTTTTTTTTTTTTTTTTTTTTTTTT